1 15 29
#############################
#p     x* *  1 * 2 *  * * * #
# # # #*# # #*#*# # # #*#*#*#
#   *     ***  *  1   * 2 * #
# # # # # #*# # #*#*# # # # #
#f           **  *  *   1   #
# # # # # # # # # #*# #*# # #
#*  *      *  *      *      #
# # # # #*# # # #*#*# # # # #
#*    **  *       *         #
# #*# # # # # # #*# # # # # #
#           *   *  *        #
# # # # #*# # # #*#*# # # # #
# # # #*# # # #*#*# # # # # #
#############################