66666666666666666666666666666
68777777777777777777777777776
67676767676767676767676767676
67777777777777777777777777776
67676767676767686767676767676
67777777777777888777777777776
67676767676867676768676767676
67777777778877777778877777776
67676767676867676768676767676
67777777777777777777777777776
67676768678767676767676867676
67777788877777888777778887776
67676768676767686767676867676
67777777777777777777777777776
66666666666666666666666666666