666666666666666666666666666666
677777777777777777777777777776
677777777777777777777777777776
677777777777777777777777777776
677777777777777777777777777776
677777777777777777777777777776
677777777777777777777777777776
677777777777777777777777777776
677777767777777777777777777776
677777767777777777777777777776
677777767777777777777777777776
677777766666666666666677777776
677777777777777777776667777776
677777777777777777777766777776
677777777777777777777776677776
677777777777777777777777667776
677777777777777777777777766776
677777777777777777777777776676
677777777777777777777777777666
666666666666666666666666666666