66666666666666666666666666666
60000000000000000000000000006
60606060606060606060606060606
60000000000000000000000000006
60606060606060686060606060606
60000000000000888000000000006
60606060606860606068606060606
60000000008800000008800000006
60606060606860606068606060606
60000000000000000000000000006
60606068608060606060606860606
60000088800000888000008880006
60606068606060686060606860606
60000000000000000000000000006
66666666666666666666666666666